Script started on Sat Jan 25 14:41:27 2020
[?1034hbash-3.2$ bin/phpunit
PHPUnit 7.5.20 by Sebastian Bergmann and contributors.

Testing Project Test Suite
...[33;1mR[0m......                                                        10 / 10 (100%)

Time: 653 ms, Memory: 34.00 MB

There was 1 risky test:

1) DeveloperSubscriberTest::testOnKernelException
This test did not perform any assertions

/Users/stephane/Desktop/tests/tests/EventSubscriber/DeveloperSubscriberTest.php:25

[30;43mOK, but incomplete, skipped, or risky tests![0m
[30;43mTests: 10[0m[30;43m, Assertions: 9[0m[30;43m, Risky: 1[0m[30;43m.[0m
bash-3.2$ bin/phpunit
PHPUnit 7.5.20 by Sebastian Bergmann and contributors.

Testing Project Test Suite
...DeveloperSubscriber.php on line 21:
Mock_ExceptionEvent_5e8b77bf {#4521
  -__phpunit_invocationMocker: PHPUnit\Framework\MockObject\InvocationMocker {#4514
    -matchers: array:1 [
      0 => PHPUnit\Framework\MockObject\Matcher {#4528
        -invocationMatcher: PHPUnit\Framework\MockObject\Matcher\AnyInvokedCount {#4532
          -invocations: array:1 [
            0 => PHPUnit\Framework\MockObject\Invocation\ObjectInvocation {#4533
              -object: Mock_ExceptionEvent_5e8b77bf {#4521}
              -className: "Symfony\Component\HttpKernel\Event\ExceptionEvent"
              -methodName: "getThrowable"
              -parameters: []
              -returnType: "Throwable"
              -isReturnTypeNullable: false
              -proxiedCall: false
            }
          ]
        }
        -afterMatchBuilderId: null
        -afterMatchBuilderIsInvoked: false
        -methodNameMatcher: PHPUnit\Framework\MockObject\Matcher\MethodName {#4516
          -constraint: PHPUnit\Framework\Constraint\IsEqual {#4504
            -value: "getThrowable"
            -delta: 0.0
            -maxDepth: 10
            -canonicalize: false
            -ignoreCase: true
            #exporter: SebastianBergmann\Exporter\Exporter {#4530}
          }
        }
        -parametersMatcher: null
        -stub: PHPUnit\Framework\MockObject\Stub\ReturnStub {#4510 …1}
      }
    ]
    -builderMap: []
    -configurableMethods: array:1 [
      0 => "getthrowable"
    ]
    -returnValueGeneration: true
  }
  -__phpunit_originalObject: null
  -__phpunit_configurable: array:1 [
    0 => "getthrowable"
  ]
  -__phpunit_returnValueGeneration: true
  -throwable: null
  -allowCustomResponseCode: false
  -response: Symfony\Component\HttpFoundation\JsonResponse {#4526
    #data: "{"status":404,"message":"Resource not found"}"
    #callback: null
    #encodingOptions: 15
    +headers: Symfony\Component\HttpFoundation\ResponseHeaderBag {#1119
      #computedCacheControl: array:2 [
        "no-cache" => true
        "private" => true
      ]
      #cookies: []
      #headerNames: array:3 [
        "cache-control" => "Cache-Control"
        "date" => "Date"
        "content-type" => "Content-Type"
      ]
      #headers: array:3 [
        "cache-control" => array:1 [
          0 => "no-cache, private"
        ]
        "date" => array:1 [
          0 => "Sat, 25 Jan 2020 07:43:28 GMT"
        ]
        "content-type" => array:1 [
          0 => "application/json"
        ]
      ]
      #cacheControl: []
    }
    #content: "{"status":404,"message":"Resource not found"}"
    #version: "1.0"
    #statusCode: 200
    #statusText: "OK"
    #charset: null
  }
  -kernel: null
  -request: null
  -requestType: null
  -propagationStopped: true
}
bash-3.2$ bin/phpini[K[K[Kunit
PHPUnit 7.5.20 by Sebastian Bergmann and contributors.

Testing Project Test Suite
...DeveloperSubscriber.php on line 21:
Mock_ExceptionEvent_dd92cf3c {#4521
  -__phpunit_invocationMocker: PHPUnit\Framework\MockObject\InvocationMocker {#4514
    -matchers: array:1 [
      0 => PHPUnit\Framework\MockObject\Matcher {#4528
        -invocationMatcher: PHPUnit\Framework\MockObject\Matcher\AnyInvokedCount {#4532
          -invocations: array:1 [
            0 => PHPUnit\Framework\MockObject\Invocation\ObjectInvocation {#4533
              -object: Mock_ExceptionEvent_dd92cf3c {#4521}
              -className: "Symfony\Component\HttpKernel\Event\ExceptionEvent"
              -methodName: "getThrowable"
              -parameters: []
              -returnType: "Throwable"
              -isReturnTypeNullable: false
              -proxiedCall: false
            }
          ]
        }
        -afterMatchBuilderId: null
        -afterMatchBuilderIsInvoked: false
        -methodNameMatcher: PHPUnit\Framework\MockObject\Matcher\MethodName {#4516
          -constraint: PHPUnit\Framework\Constraint\IsEqual {#4504
            -value: "getThrowable"
            -delta: 0.0
            -maxDepth: 10
            -canonicalize: false
            -ignoreCase: true
            #exporter: SebastianBergmann\Exporter\Exporter {#4530}
          }
        }
        -parametersMatcher: null
        -stub: PHPUnit\Framework\MockObject\Stub\ReturnStub {#4510 …1}
      }
    ]
    -builderMap: []
    -configurableMethods: array:1 [
      0 => "getthrowable"
    ]
    -returnValueGeneration: true
  }
  -__phpunit_originalObject: null
  -__phpunit_configurable: array:1 [
    0 => "getthrowable"
  ]
  -__phpunit_returnValueGeneration: true
  -throwable: null
  -allowCustomResponseCode: false
  -response: Symfony\Component\HttpFoundation\JsonResponse {#4526
    #data: "{"status":404,"message":"Resource not found"}"
    #callback: null
    #encodingOptions: 15
    +headers: Symfony\Component\HttpFoundation\ResponseHeaderBag {#1119
      #computedCacheControl: array:2 [
        "no-cache" => true
        "private" => true
      ]
      #cookies: []
      #headerNames: array:3 [
        "cache-control" => "Cache-Control"
        "date" => "Date"
        "content-type" => "Content-Type"
      ]
      #headers: array:3 [
        "cache-control" => array:1 [
          0 => "no-cache, private"
        ]
        "date" => array:1 [
          0 => "Sat, 25 Jan 2020 07:43:45 GMT"
        ]
        "content-type" => array:1 [
          0 => "application/json"
        ]
      ]
      #cacheControl: []
    }
    #content: "{"status":404,"message":"Resource not found"}"
    #version: "1.0"
    #statusCode: 200
    #statusText: "OK"
    #charset: null
  }
  -kernel: null
  -request: null
  -requestType: null
  -propagationStopped: true
}
bash-3.2$ binp[K/phpunit
PHPUnit 7.5.20 by Sebastian Bergmann and contributors.

Testing Project Test Suite
...[33;1mR[0m......                                                        10 / 10 (100%)

Time: 645 ms, Memory: 34.00 MB

There was 1 risky test:

1) DeveloperSubscriberTest::testOnKernelException
This test did not perform any assertions

/Users/stephane/Desktop/tests/tests/EventSubscriber/DeveloperSubscriberTest.php:25

[30;43mOK, but incomplete, skipped, or risky tests![0m
[30;43mTests: 10[0m[30;43m, Assertions: 9[0m[30;43m, Risky: 1[0m[30;43m.[0m
bash-3.2$ bin/phpunit
PHPUnit 7.5.20 by Sebastian Bergmann and contributors.

Testing Project Test Suite
...DeveloperSubscriber.php on line 21:
Symfony\Component\HttpFoundation\JsonResponse {#4526
  #data: "{"status":404,"message":"Resource not found"}"
  #callback: null
  #encodingOptions: 15
  +headers: Symfony\Component\HttpFoundation\ResponseHeaderBag {#1119
    #computedCacheControl: array:2 [
      "no-cache" => true
      "private" => true
    ]
    #cookies: []
    #headerNames: array:3 [
      "cache-control" => "Cache-Control"
      "date" => "Date"
      "content-type" => "Content-Type"
    ]
    #headers: array:3 [
      "cache-control" => array:1 [
        0 => "no-cache, private"
      ]
      "date" => array:1 [
        0 => "Sat, 25 Jan 2020 07:46:57 GMT"
      ]
      "content-type" => array:1 [
        0 => "application/json"
      ]
    ]
    #cacheControl: []
  }
  #content: "{"status":404,"message":"Resource not found"}"
  #version: "1.0"
  #statusCode: 200
  #statusText: "OK"
  #charset: null
}
bash-3.2$ bin/phpunit
PHPUnit 7.5.20 by Sebastian Bergmann and contributors.

Testing Project Test Suite
...[33;1mR[0m......                                                        10 / 10 (100%)

Time: 644 ms, Memory: 34.00 MB

There was 1 risky test:

1) DeveloperSubscriberTest::testOnKernelException
This test did not perform any assertions

/Users/stephane/Desktop/tests/tests/EventSubscriber/DeveloperSubscriberTest.php:25

[30;43mOK, but incomplete, skipped, or risky tests![0m
[30;43mTests: 10[0m[30;43m, Assertions: 9[0m[30;43m, Risky: 1[0m[30;43m.[0m
bash-3.2$ bin/phpunit
PHPUnit 7.5.20 by Sebastian Bergmann and contributors.

Testing Project Test Suite
...[33;1mR[0m......                                                        10 / 10 (100%)

Time: 654 ms, Memory: 34.00 MB

There was 1 risky test:

1) DeveloperSubscriberTest::testOnKernelException
This test did not perform any assertions

/Users/stephane/Desktop/tests/tests/EventSubscriber/DeveloperSubscriberTest.php:25

[30;43mOK, but incomplete, skipped, or risky tests![0m
[30;43mTests: 10[0m[30;43m, Assertions: 9[0m[30;43m, Risky: 1[0m[30;43m.[0m
bash-3.2$ bin/phpunit
PHPUnit 7.5.20 by Sebastian Bergmann and contributors.

Testing Project Test Suite
...[31;1mE[0m......                                                        10 / 10 (100%)

Time: 641 ms, Memory: 34.00 MB

There was 1 error:

1) DeveloperSubscriberTest::testOnKernelException
Error: Call to undefined method DeveloperSubscriberTest::filter()

/Users/stephane/Desktop/tests/tests/EventSubscriber/DeveloperSubscriberTest.php:33

[37;41mERRORS![0m
[37;41mTests: 10[0m[37;41m, Assertions: 9[0m[37;41m, Errors: 1[0m[37;41m.[0m
bash-3.2$ bin/hp[K[K[K/p[hp[K[K[K[Kphpunit
PHPUnit 7.5.20 by Sebastian Bergmann and contributors.

Testing Project Test Suite
...DeveloperSubscriber.php on line 21:
Symfony\Component\HttpFoundation\JsonResponse {#4526
  #data: "{"status":404,"message":"Resource not found"}"
  #callback: null
  #encodingOptions: 15
  +headers: Symfony\Component\HttpFoundation\ResponseHeaderBag {#1119
    #computedCacheControl: array:2 [
      "no-cache" => true
      "private" => true
    ]
    #cookies: []
    #headerNames: array:3 [
      "cache-control" => "Cache-Control"
      "date" => "Date"
      "content-type" => "Content-Type"
    ]
    #headers: array:3 [
      "cache-control" => array:1 [
        0 => "no-cache, private"
      ]
      "date" => array:1 [
        0 => "Sat, 25 Jan 2020 07:52:07 GMT"
      ]
      "content-type" => array:1 [
        0 => "application/json"
      ]
    ]
    #cacheControl: []
  }
  #content: "{"status":404,"message":"Resource not found"}"
  #version: "1.0"
  #statusCode: 200
  #statusText: "OK"
  #charset: null
}
bash-3.2$ i[Kbin/phpunit
PHPUnit 7.5.20 by Sebastian Bergmann and contributors.

Testing Project Test Suite
...[31;1mE[0m......                                                        10 / 10 (100%)

Time: 648 ms, Memory: 34.00 MB

There was 1 error:

1) DeveloperSubscriberTest::testOnKernelException
get_class() expects parameter 1 to be object, null given

/Users/stephane/Desktop/tests/tests/EventSubscriber/DeveloperSubscriberTest.php:33

[37;41mERRORS![0m
[37;41mTests: 10[0m[37;41m, Assertions: 9[0m[37;41m, Errors: 1[0m[37;41m.[0m
bash-3.2$ bin/phpunit
PHPUnit 7.5.20 by Sebastian Bergmann and contributors.

Testing Project Test Suite
...DeveloperSubscriberTest.php on line 33:
null
bash-3.2$ bin/phpunit
PHPUnit 7.5.20 by Sebastian Bergmann and contributors.

Testing Project Test Suite
...DeveloperSubscriberTest.php on line 28:
PHPUnit\Framework\MockObject\Builder\InvocationMocker {#4518
  -collection: PHPUnit\Framework\MockObject\InvocationMocker {#4514
    -matchers: array:1 [
      0 => PHPUnit\Framework\MockObject\Matcher {#4528
        -invocationMatcher: PHPUnit\Framework\MockObject\Matcher\AnyInvokedCount {#4532
          -invocations: []
        }
        -afterMatchBuilderId: null
        -afterMatchBuilderIsInvoked: false
        -methodNameMatcher: PHPUnit\Framework\MockObject\Matcher\MethodName {#4516
          -constraint: PHPUnit\Framework\Constraint\IsEqual {#4504
            -value: "getThrowable"
            -delta: 0.0
            -maxDepth: 10
            -canonicalize: false
            -ignoreCase: true
            #exporter: SebastianBergmann\Exporter\Exporter {#4530}
          }
        }
        -parametersMatcher: null
        -stub: PHPUnit\Framework\MockObject\Stub\ReturnStub {#4510 …1}
      }
    ]
    -builderMap: []
    -configurableMethods: array:1 [
      0 => "getthrowable"
    ]
    -returnValueGeneration: true
  }
  -matcher: PHPUnit\Framework\MockObject\Matcher {#4528}
  -configurableMethods: array:1 [
    0 => "getthrowable"
  ]
}
bash-3.2$ bin/phpunit
PHPUnit 7.5.20 by Sebastian Bergmann and contributors.

Testing Project Test Suite
...DeveloperSubscriberTest.php on line 28:
Mock_NotFoundHttpException_02d7df59 {#4513
  -__phpunit_invocationMocker: null
  -__phpunit_originalObject: null
  -__phpunit_configurable: array:1 [
    0 => "getstatuscode"
  ]
  -__phpunit_returnValueGeneration: true
  -statusCode: null
  -headers: null
  #message: ""
  #code: 0
  #file: "./vendor/doctrine/instantiator/src/Doctrine/Instantiator/Instantiator.php"
  #line: 73
  trace: {
    ./vendor/doctrine/instantiator/src/Doctrine/Instantiator/Instantiator.php:73 { …}
    ./vendor/doctrine/instantiator/src/Doctrine/Instantiator/Instantiator.php:62 { …}
    ./bin/.phpunit/phpunit-7.5-0/src/Framework/MockObject/Generator.php:615 {
      PHPUnit\Framework\MockObject\Generator->getObject($code, $className, $type = '', $callOriginalConstructor = false, $callAutoload = false, array $arguments = [], $callOriginalMethods = false, $proxyTarget = null, $returnValueGeneration = true)
      ›     $instantiator = new Instantiator;
      ›     $object       = $instantiator->instantiate($className);
      › } catch (InstantiatorException $exception) {
      arguments: {
        $className: "Mock_NotFoundHttpException_02d7df59"
      }
    }
    ./bin/.phpunit/phpunit-7.5-0/src/Framework/MockObject/Generator.php:200 { …}
    ./bin/.phpunit/phpunit-7.5-0/src/Framework/MockObject/MockBuilder.php:123 { …}
    ./tests/EventSubscriber/DeveloperSubscriberTest.php:22 { …}
    ./bin/.phpunit/phpunit-7.5-0/src/Framework/TestCase.php:839 { …}
    ./bin/.phpunit/phpunit-7.5-0/src/Framework/TestResult.php:693 { …}
    ./bin/.phpunit/phpunit-7.5-0/src/Framework/TestCase.php:797 { …}
    ./bin/.phpunit/phpunit-7.5-0/src/Framework/TestSuite.php:746 { …}
    ./bin/.phpunit/phpunit-7.5-0/src/Framework/TestSuite.php:746 { …}
    ./bin/.phpunit/phpunit-7.5-0/src/TextUI/TestRunner.php:652 { …}
    ./bin/.phpunit/phpunit-7.5-0/src/TextUI/Command.php:206 { …}
    ./bin/.phpunit/phpunit-7.5-0/src/TextUI/Command.php:162 { …}
    ./bin/.phpunit/phpunit-7.5-0/phpunit:17 { …}
    ./vendor/symfony/phpunit-bridge/bin/simple-phpunit.php:302 { …}
    ./bin/phpunit:13 { …}
  }
}
bash-3.2$ dd[K[Kbin/phpunit
PHPUnit 7.5.20 by Sebastian Bergmann and contributors.

Testing Project Test Suite
...DeveloperSubscriberTest.php on line 29:
PHPUnit\Framework\MockObject\Builder\InvocationMocker {#4503
  -collection: PHPUnit\Framework\MockObject\InvocationMocker {#4531
    -matchers: array:1 [
      0 => PHPUnit\Framework\MockObject\Matcher {#4506
        -invocationMatcher: PHPUnit\Framework\MockObject\Matcher\AnyInvokedCount {#4507
          -invocations: []
        }
        -afterMatchBuilderId: null
        -afterMatchBuilderIsInvoked: false
        -methodNameMatcher: PHPUnit\Framework\MockObject\Matcher\MethodName {#4508
          -constraint: PHPUnit\Framework\Constraint\IsEqual {#4522
            -value: "getStatusCode"
            -delta: 0.0
            -maxDepth: 10
            -canonicalize: false
            -ignoreCase: true
            #exporter: SebastianBergmann\Exporter\Exporter {#4517}
          }
        }
        -parametersMatcher: null
        -stub: PHPUnit\Framework\MockObject\Stub\ReturnStub {#4533 …1}
      }
    ]
    -builderMap: []
    -configurableMethods: array:1 [
      0 => "getstatuscode"
    ]
    -returnValueGeneration: true
  }
  -matcher: PHPUnit\Framework\MockObject\Matcher {#4506}
  -configurableMethods: array:1 [
    0 => "getstatuscode"
  ]
}
bash-3.2$ bin/phpunit
PHPUnit 7.5.20 by Sebastian Bergmann and contributors.

Testing Project Test Suite
...[31;1mE[0m......                                                        10 / 10 (100%)

Time: 656 ms, Memory: 34.00 MB

There was 1 error:

1) DeveloperSubscriberTest::testOnKernelException
TypeError: Argument 1 passed to App\EventSubscriber\DeveloperSubscriber::onKernelException() must be an instance of Symfony\Component\HttpKernel\Event\ExceptionEvent, string given, called in /Users/stephane/Desktop/tests/tests/EventSubscriber/DeveloperSubscriberTest.php on line 31

/Users/stephane/Desktop/tests/src/EventSubscriber/DeveloperSubscriber.php:11
/Users/stephane/Desktop/tests/tests/EventSubscriber/DeveloperSubscriberTest.php:31

[37;41mERRORS![0m
[37;41mTests: 10[0m[37;41m, Assertions: 9[0m[37;41m, Errors: 1[0m[37;41m.[0m
bash-3.2$ bin/phpunit
PHPUnit 7.5.20 by Sebastian Bergmann and contributors.

Testing Project Test Suite
...[31;1mE[0m......                                                        10 / 10 (100%)

Time: 657 ms, Memory: 34.00 MB

There was 1 error:

1) DeveloperSubscriberTest::testOnKernelException
Use of undefined constant ExceptionEvent - assumed 'ExceptionEvent' (this will throw an Error in a future version of PHP)

/Users/stephane/Desktop/tests/tests/EventSubscriber/DeveloperSubscriberTest.php:31

[37;41mERRORS![0m
[37;41mTests: 10[0m[37;41m, Assertions: 9[0m[37;41m, Errors: 1[0m[37;41m.[0m
bash-3.2$ bin/phpunit
PHPUnit 7.5.20 by Sebastian Bergmann and contributors.

Testing Project Test Suite
...[31;1mE[0m......                                                        10 / 10 (100%)

Time: 647 ms, Memory: 34.00 MB

There was 1 error:

1) DeveloperSubscriberTest::testOnKernelException
get_class() expects parameter 1 to be object, null given

/Users/stephane/Desktop/tests/tests/EventSubscriber/DeveloperSubscriberTest.php:33

[37;41mERRORS![0m
[37;41mTests: 10[0m[37;41m, Assertions: 9[0m[37;41m, Errors: 1[0m[37;41m.[0m
bash-3.2$ bin/phpunit
PHPUnit 7.5.20 by Sebastian Bergmann and contributors.

Testing Project Test Suite
...[31;1mE[0m......                                                        10 / 10 (100%)

Time: 649 ms, Memory: 34.00 MB

There was 1 error:

1) DeveloperSubscriberTest::testOnKernelException
get_class() expects parameter 1 to be object, null given

/Users/stephane/Desktop/tests/tests/EventSubscriber/DeveloperSubscriberTest.php:33

[37;41mERRORS![0m
[37;41mTests: 10[0m[37;41m, Assertions: 9[0m[37;41m, Errors: 1[0m[37;41m.[0m
bash-3.2$ bin/phpunit
PHPUnit 7.5.20 by Sebastian Bergmann and contributors.

Testing Project Test Suite
...[31;1mE[0m......                                                        10 / 10 (100%)

Time: 642 ms, Memory: 34.00 MB

There was 1 error:

1) DeveloperSubscriberTest::testOnKernelException
get_class() expects parameter 1 to be object, null given

/Users/stephane/Desktop/tests/tests/EventSubscriber/DeveloperSubscriberTest.php:33

[37;41mERRORS![0m
[37;41mTests: 10[0m[37;41m, Assertions: 9[0m[37;41m, Errors: 1[0m[37;41m.[0m
bash-3.2$ bo[Ko[Kin/phpunit
PHPUnit 7.5.20 by Sebastian Bergmann and contributors.

Testing Project Test Suite
...[41;37mF[0m......                                                        10 / 10 (100%)

Time: 651 ms, Memory: 34.00 MB

There was 1 failure:

1) DeveloperSubscriberTest::testOnKernelException
Failed asserting that two strings are equal.
--- Expected
+++ Actual
@@ @@
-'Symfony\Component\HttpFoundation\JsonResponse'
+'Mock_ExceptionEvent_99f27133'

/Users/stephane/Desktop/tests/tests/EventSubscriber/DeveloperSubscriberTest.php:33

[37;41mFAILURES![0m
[37;41mTests: 10[0m[37;41m, Assertions: 10[0m[37;41m, Failures: 1[0m[37;41m.[0m
bash-3.2$ bin/phpunit
PHPUnit 7.5.20 by Sebastian Bergmann and contributors.

Testing Project Test Suite
...[31;1mE[0m......                                                        10 / 10 (100%)

Time: 666 ms, Memory: 34.00 MB

There was 1 error:

1) DeveloperSubscriberTest::testOnKernelException
get_class() expects parameter 1 to be object, null given

/Users/stephane/Desktop/tests/tests/EventSubscriber/DeveloperSubscriberTest.php:33

[37;41mERRORS![0m
[37;41mTests: 10[0m[37;41m, Assertions: 9[0m[37;41m, Errors: 1[0m[37;41m.[0m
bash-3.2$ bin/phpunit
PHPUnit 7.5.20 by Sebastian Bergmann and contributors.

Testing Project Test Suite
..........                                                        10 / 10 (100%)

Time: 890 ms, Memory: 34.00 MB

[30;42mOK (10 tests, 10 assertions)[0m
bash-3.2$ bin/phpunit
PHPUnit 7.5.20 by Sebastian Bergmann and contributors.

Testing Project Test Suite
...DeveloperSubscriberTest.php on line 32:
Symfony\Component\HttpFoundation\JsonResponse {#4502
  #data: "{}"
  #callback: null
  #encodingOptions: 15
  +headers: Symfony\Component\HttpFoundation\ResponseHeaderBag {#1117
    #computedCacheControl: array:2 [
      "no-cache" => true
      "private" => true
    ]
    #cookies: []
    #headerNames: array:3 [
      "cache-control" => "Cache-Control"
      "date" => "Date"
      "content-type" => "Content-Type"
    ]
    #headers: array:3 [
      "cache-control" => array:1 [
        0 => "no-cache, private"
      ]
      "date" => array:1 [
        0 => "Sat, 25 Jan 2020 08:02:44 GMT"
      ]
      "content-type" => array:1 [
        0 => "application/json"
      ]
    ]
    #cacheControl: []
  }
  #content: "{}"
  #version: "1.0"
  #statusCode: 200
  #statusText: "OK"
  #charset: null
}
bash-3.2$ bin/phpunit
PHPUnit 7.5.20 by Sebastian Bergmann and contributors.

Testing Project Test Suite
..........                                                        10 / 10 (100%)

Time: 651 ms, Memory: 34.00 MB

[30;42mOK (10 tests, 10 assertions)[0m
bash-3.2$ bin/hpp[K[K[Kphpunit
PHPUnit 7.5.20 by Sebastian Bergmann and contributors.

Testing Project Test Suite
...[41;37mF[0m......                                                        10 / 10 (100%)

Time: 667 ms, Memory: 34.00 MB

There was 1 failure:

1) DeveloperSubscriberTest::testOnKernelException
Failed asserting that two strings are equal.
--- Expected
+++ Actual
@@ @@
-'Symfony\Component\HttpKernel\Event\ExceptionEvent'
+'Mock_ExceptionEvent_987e8790'

/Users/stephane/Desktop/tests/tests/EventSubscriber/DeveloperSubscriberTest.php:33

[37;41mFAILURES![0m
[37;41mTests: 10[0m[37;41m, Assertions: 10[0m[37;41m, Failures: 1[0m[37;41m.[0m
bash-3.2$ bin/phpunit
PHPUnit 7.5.20 by Sebastian Bergmann and contributors.

Testing Project Test Suite
...[41;37mF[0m......                                                        10 / 10 (100%)

Time: 648 ms, Memory: 34.00 MB

There was 1 failure:

1) DeveloperSubscriberTest::testOnKernelException
Failed asserting that two strings are equal.
--- Expected
+++ Actual
@@ @@
-'Mock_ExceptionEvent_987e8790'
+'Mock_ExceptionEvent_a0c6e190'

/Users/stephane/Desktop/tests/tests/EventSubscriber/DeveloperSubscriberTest.php:33

[37;41mFAILURES![0m
[37;41mTests: 10[0m[37;41m, Assertions: 10[0m[37;41m, Failures: 1[0m[37;41m.[0m
bash-3.2$ ph[K[Kbin/phpunit
PHPUnit 7.5.20 by Sebastian Bergmann and contributors.

Testing Project Test Suite
..........                                                        10 / 10 (100%)

Time: 655 ms, Memory: 34.00 MB

[30;42mOK (10 tests, 10 assertions)[0m
bash-3.2$ bin/phpunit
PHPUnit 7.5.20 by Sebastian Bergmann and contributors.

Testing Project Test Suite
...[31;1mE[0m......                                                        10 / 10 (100%)

Time: 665 ms, Memory: 34.00 MB

There was 1 error:

1) DeveloperSubscriberTest::testOnKernelException
get_class() expects parameter 1 to be object, null given

/Users/stephane/Desktop/tests/tests/EventSubscriber/DeveloperSubscriberTest.php:33

[37;41mERRORS![0m
[37;41mTests: 10[0m[37;41m, Assertions: 9[0m[37;41m, Errors: 1[0m[37;41m.[0m
bash-3.2$ hp[K[Kphpunit[K[K[K[K[K[K[Kbin/phpunit
PHPUnit 7.5.20 by Sebastian Bergmann and contributors.

Testing Project Test Suite
...DeveloperSubscriberTest.php on line 33:
null
bash-3.2$ bin /phpunit
bash: bin: command not found
bash-3.2$ n[Kbin/phpunit
PHP Parse error:  syntax error, unexpected '->' (T_OBJECT_OPERATOR), expecting ',' or ')' in /Users/stephane/Desktop/tests/tests/EventSubscriber/DeveloperSubscriberTest.php on line 31

Parse error: syntax error, unexpected '->' (T_OBJECT_OPERATOR), expecting ',' or ')' in /Users/stephane/Desktop/tests/tests/EventSubscriber/DeveloperSubscriberTest.php on line 31

bash-3.2$ bin/phpunit
PHPUnit 7.5.20 by Sebastian Bergmann and contributors.

Testing Project Test Suite
...DeveloperSubscriberTest.php on line 31:
null
bash-3.2$ bin/phpunit
PHPUnit 7.5.20 by Sebastian Bergmann and contributors.

Testing Project Test Suite
...[33;1mR[0m......                                                        10 / 10 (100%)

Time: 668 ms, Memory: 34.00 MB

There was 1 risky test:

1) DeveloperSubscriberTest::testOnKernelException
This test did not perform any assertions

/Users/stephane/Desktop/tests/tests/EventSubscriber/DeveloperSubscriberTest.php:25

[30;43mOK, but incomplete, skipped, or risky tests![0m
[30;43mTests: 10[0m[30;43m, Assertions: 9[0m[30;43m, Risky: 1[0m[30;43m.[0m
bash-3.2$ bin/phpunit
PHPUnit 7.5.20 by Sebastian Bergmann and contributors.

Testing Project Test Suite
...DeveloperSubscriberTest.php on line 31:
null
bash-3.2$ bin/phpunit
PHPUnit 7.5.20 by Sebastian Bergmann and contributors.

Testing Project Test Suite
...DeveloperSubscriberTest.php on line 31:
Symfony\Component\HttpFoundation\JsonResponse {#4502
  #data: "{"status":404,"message":"Resource not found"}"
  #callback: null
  #encodingOptions: 15
  +headers: Symfony\Component\HttpFoundation\ResponseHeaderBag {#1117
    #computedCacheControl: array:2 [
      "no-cache" => true
      "private" => true
    ]
    #cookies: []
    #headerNames: array:3 [
      "cache-control" => "Cache-Control"
      "date" => "Date"
      "content-type" => "Content-Type"
    ]
    #headers: array:3 [
      "cache-control" => array:1 [
        0 => "no-cache, private"
      ]
      "date" => array:1 [
        0 => "Sat, 25 Jan 2020 08:08:16 GMT"
      ]
      "content-type" => array:1 [
        0 => "application/json"
      ]
    ]
    #cacheControl: []
  }
  #content: "{"status":404,"message":"Resource not found"}"
  #version: "1.0"
  #statusCode: 200
  #statusText: "OK"
  #charset: null
}
bash-3.2$ bin/phpunit
PHPUnit 7.5.20 by Sebastian Bergmann and contributors.

Testing Project Test Suite
...DeveloperSubscriberTest.php on line 31:
Symfony\Component\HttpFoundation\JsonResponse {#4502
  #data: "{"status":404,"message":"Resource not found"}"
  #callback: null
  #encodingOptions: 15
  +headers: Symfony\Component\HttpFoundation\ResponseHeaderBag {#1117
    #computedCacheControl: array:2 [
      "no-cache" => true
      "private" => true
    ]
    #cookies: []
    #headerNames: array:3 [
      "cache-control" => "Cache-Control"
      "date" => "Date"
      "content-type" => "Content-Type"
    ]
    #headers: array:3 [
      "cache-control" => array:1 [
        0 => "no-cache, private"
      ]
      "date" => array:1 [
        0 => "Sat, 25 Jan 2020 08:08:58 GMT"
      ]
      "content-type" => array:1 [
        0 => "application/json"
      ]
    ]
    #cacheControl: []
  }
  #content: "{"status":404,"message":"Resource not found"}"
  #version: "1.0"
  #statusCode: 200
  #statusText: "OK"
  #charset: null
}
bash-3.2$ bin/phpunit
PHPUnit 7.5.20 by Sebastian Bergmann and contributors.

Testing Project Test Suite
..........                                                        10 / 10 (100%)

Time: 667 ms, Memory: 34.00 MB

[30;42mOK (10 tests, 10 assertions)[0m
bash-3.2$ bin/phpunit --filter=testOnKernelException > public resultTest.html
bash: public: Is a directory
bash-3.2$ bin/phpunit
PHPUnit 7.5.20 by Sebastian Bergmann and contributors.

Testing Project Test Suite
..........                                                        10 / 10 (100%)

Time: 665 ms, Memory: 34.00 MB

[30;42mOK (10 tests, 10 assertions)[0m
bash-3.2$ bin/phpunit
PHPUnit 7.5.20 by Sebastian Bergmann and contributors.

Testing Project Test Suite
...DeveloperSubscriberTest.php on line 33:
Symfony\Component\HttpFoundation\JsonResponse {#4502
  #data: "{"status":404,"message":"Resource not found"}"
  #callback: null
  #encodingOptions: 15
  +headers: Symfony\Component\HttpFoundation\ResponseHeaderBag {#1117
    #computedCacheControl: array:2 [
      "no-cache" => true
      "private" => true
    ]
    #cookies: []
    #headerNames: array:3 [
      "cache-control" => "Cache-Control"
      "date" => "Date"
      "content-type" => "Content-Type"
    ]
    #headers: array:3 [
      "cache-control" => array:1 [
        0 => "no-cache, private"
      ]
      "date" => array:1 [
        0 => "Sat, 25 Jan 2020 08:12:09 GMT"
      ]
      "content-type" => array:1 [
        0 => "application/json"
      ]
    ]
    #cacheControl: []
  }
  #content: "{"status":404,"message":"Resource not found"}"
  #version: "1.0"
  #statusCode: 200
  #statusText: "OK"
  #charset: null
}
bash-3.2$ bin/phpunit
PHPUnit 7.5.20 by Sebastian Bergmann and contributors.

Testing Project Test Suite
..........                                                        10 / 10 (100%)

Time: 670 ms, Memory: 34.00 MB

[30;42mOK (10 tests, 10 assertions)[0m
bash-3.2$ git init 
Initialized empty Git repository in /Users/stephane/Desktop/tests/.git/
bash-3.2$ git add .
bash-3.2$ git commit -am ''t'r'a'v'i's' 'f'i'r's't' 'c'o'm'm'i't'
[master (root-commit) 8665991] travis first commit
 Committer: Stephane <stephane@MacBook-Pro-de-Stephane.local>
Your name and email address were configured automatically based
on your username and hostname. Please check that they are accurate.
You can suppress this message by setting them explicitly. Run the
following command and follow the instructions in your editor to edit
your configuration file:

    git config --global --edit

After doing this, you may fix the identity used for this commit with:

    git commit --amend --reset-author

 128 files changed, 19503 insertions(+)
 create mode 100644 .env
 create mode 100644 .env.test
 create mode 100644 .gitignore
 create mode 100755 bin/console
 create mode 100755 bin/phpunit
 create mode 100644 cache
 create mode 100644 cache:clear
 create mode 100644 composer.json
 create mode 100644 composer.lock
 create mode 100644 config/bootstrap.php
 create mode 100644 config/bundles.php
 create mode 100644 config/packages/cache.yaml
 create mode 100644 config/packages/dev/debug.yaml
 create mode 100644 config/packages/dev/easy_log_handler.yaml
 create mode 100644 config/packages/dev/monolog.yaml
 create mode 100644 config/packages/dev/web_profiler.yaml
 create mode 100644 config/packages/doctrine.yaml
 create mode 100644 config/packages/doctrine_migrations.yaml
 create mode 100644 config/packages/framework.yaml
 create mode 100644 config/packages/mailer.yaml
 create mode 100644 config/packages/notifier.yaml
 create mode 100644 config/packages/prod/doctrine.yaml
 create mode 100644 config/packages/prod/monolog.yaml
 create mode 100644 config/packages/prod/routing.yaml
 create mode 100644 config/packages/routing.yaml
 create mode 100644 config/packages/security.yaml
 create mode 100644 config/packages/sensio_framework_extra.yaml
 create mode 100644 config/packages/test/framework.yaml
 create mode 100644 config/packages/test/monolog.yaml
 create mode 100644 config/packages/test/twig.yaml
 create mode 100644 config/packages/test/validator.yaml
 create mode 100644 config/packages/test/web_profiler.yaml
 create mode 100644 config/packages/translation.yaml
 create mode 100644 config/packages/twig.yaml
 create mode 100644 config/packages/validator.yaml
 create mode 100644 config/routes.yaml
 create mode 100644 config/routes/annotations.yaml
 create mode 100644 config/routes/dev/framework.yaml
 create mode 100644 config/routes/dev/web_profiler.yaml
 create mode 100644 config/services.yaml
 create mode 100644 phpunit.xml.dist
 create mode 100644 public/index.php
 create mode 100644 public/resultTest.html
 create mode 100644 public/test-coverage/.css/bootstrap.min.css
 create mode 100644 public/test-coverage/.css/custom.css
 create mode 100644 public/test-coverage/.css/nv.d3.min.css
 create mode 100644 public/test-coverage/.css/octicons.css
 create mode 100644 public/test-coverage/.css/style.css
 create mode 100644 public/test-coverage/.icons/file-code.svg
 create mode 100644 public/test-coverage/.icons/file-directory.svg
 create mode 100644 public/test-coverage/.js/bootstrap.min.js
 create mode 100644 public/test-coverage/.js/d3.min.js
 create mode 100644 public/test-coverage/.js/file.js
 create mode 100644 public/test-coverage/.js/jquery.min.js
 create mode 100644 public/test-coverage/.js/nv.d3.min.js
 create mode 100644 public/test-coverage/.js/popper.min.js
 create mode 100644 public/test-coverage/Controller/DeveloperController.php.html
 create mode 100644 public/test-coverage/Controller/dashboard.html
 create mode 100644 public/test-coverage/Controller/index.html
 create mode 100644 public/test-coverage/DataFixtures/AppFixtures.php.html
 create mode 100644 public/test-coverage/DataFixtures/DevloperFixture.php.html
 create mode 100644 public/test-coverage/DataFixtures/dashboard.html
 create mode 100644 public/test-coverage/DataFixtures/index.html
 create mode 100644 public/test-coverage/Entity/Developer.php.html
 create mode 100644 public/test-coverage/Entity/dashboard.html
 create mode 100644 public/test-coverage/Entity/index.html
 create mode 100644 public/test-coverage/Form/DeveloperType.php.html
 create mode 100644 public/test-coverage/Form/dashboard.html
 create mode 100644 public/test-coverage/Form/index.html
 create mode 100644 public/test-coverage/Kernel.php.html
 create mode 100644 public/test-coverage/Migrations/Version20200124092614.php.html
 create mode 100644 public/test-coverage/Migrations/Version20200124095504.php.html
 create mode 100644 public/test-coverage/Migrations/Version20200124100205.php.html
 create mode 100644 public/test-coverage/Migrations/Version20200124101111.php.html
 create mode 100644 public/test-coverage/Migrations/Version20200124102038.php.html
 create mode 100644 public/test-coverage/Migrations/Version20200124103555.php.html
 create mode 100644 public/test-coverage/Migrations/Version20200124144546.php.html
 create mode 100644 public/test-coverage/Migrations/dashboard.html
 create mode 100644 public/test-coverage/Migrations/index.html
 create mode 100644 public/test-coverage/Repository/DeveloperRepository.php.html
 create mode 100644 public/test-coverage/Repository/dashboard.html
 create mode 100644 public/test-coverage/Repository/index.html
 create mode 100644 public/test-coverage/Service/countDeveloperPrice.php.html
 create mode 100644 public/test-coverage/Service/dashboard.html
 create mode 100644 public/test-coverage/Service/index.html
 create mode 100644 public/test-coverage/dashboard.html
 create mode 100644 public/test-coverage/index.html
 create mode 100644 src/Controller/.gitignore
 create mode 100644 src/Controller/DeveloperController.php
 create mode 100644 src/Controller/SecurityController.php
 create mode 100644 src/Controller/api/DevApiController.php
 create mode 100644 src/DataFixtures/AppFixtures.php
 create mode 100644 src/DataFixtures/DevloperFixture.php
 create mode 100644 src/DataFixtures/UserFixture.php
 create mode 100644 src/Entity/.gitignore
 create mode 100644 src/Entity/Developer.php
 create mode 100644 src/Entity/User.php
 create mode 100644 src/EventSubscriber/DeveloperSubscriber.php
 create mode 100644 src/Form/DeveloperType.php
 create mode 100644 src/Kernel.php
 create mode 100644 src/Migrations/.gitignore
 create mode 100644 src/Migrations/Version20200124092614.php
 create mode 100644 src/Migrations/Version20200124095504.php
 create mode 100644 src/Migrations/Version20200124100205.php
 create mode 100644 src/Migrations/Version20200124101111.php
 create mode 100644 src/Migrations/Version20200124102038.php
 create mode 100644 src/Migrations/Version20200124103555.php
 create mode 100644 src/Migrations/Version20200124144546.php
 create mode 100644 src/Migrations/Version20200125010750.php
 create mode 100644 src/Repository/.gitignore
 create mode 100644 src/Repository/DeveloperRepository.php
 create mode 100644 src/Repository/UserRepository.php
 create mode 100644 src/Security/UserAuthenticator.php
 create mode 100644 src/Service/countDeveloperPrice.php
 create mode 100644 symfony.lock
 create mode 100644 templates/base.html.twig
 create mode 100644 templates/developer/_delete_form.html.twig
 create mode 100644 templates/developer/_form.html.twig
 create mode 100644 templates/developer/edit.html.twig
 create mode 100644 templates/developer/index.html.twig
 create mode 100644 templates/developer/new.html.twig
 create mode 100644 templates/developer/show.html.twig
 create mode 100644 templates/security/login.html.twig
 create mode 100644 tests/.gitignore
 create mode 100644 tests/Controller/developerControllerTest.php
 create mode 100644 tests/EventSubscriber/DeveloperSubscriberTest.php
 create mode 100644 tests/Service/countDeveloperPriceTest.php
 create mode 100644 translations/.gitignore
bash-3.2$ cd /users/stephane/desktop
bash-3.2$ git rmote [1@e[C[C[C[C[C a d d [C o r i g i n [C h t t p s : / / g i t h u b . c o m / s k e r g o a t / D u m m y - S y m f o n y - T e s t - . g i t 
fatal: not a git repository (or any of the parent directories): .git
bash-3.2$ git rmote [K[K[K[K[Kemote add origin https://github.com/skergoat/Dummy-Symfony-Test-.git
fatal: not a git repository (or any of the parent directories): .git
bash-3.2$ git remote add origin https://github.com/skergoat/Dummy-Symfony-Test-.git
fatal: not a git repository (or any of the parent directories): .git
bash-3.2$ git [K[K[K[Kcd tests
bash-3.2$ git remote origin [C[1@ [1@a[1@d[1@d[C[1@ [C[C[C[C[C[1P[C[C[C[C[C[C[C[C h t t p s : / / g i t h u b . c o m / s k e r g o a t / D u m m y - S y m f o n y - T e s t s - . g i t 
bash-3.2$ git pull origin msster [K[K[K[K[K[Kaster
warning: no common commits
remote: Enumerating objects: 3, done.[K
remote: Counting objects:  33% (1/3)[Kremote: Counting objects:  66% (2/3)[Kremote: Counting objects: 100% (3/3)[Kremote: Counting objects: 100% (3/3), done.[K
remote: Total 3 (delta 0), reused 0 (delta 0), pack-reused 0[K
Unpacking objects:  33% (1/3)   Unpacking objects:  66% (2/3)   Unpacking objects: 100% (3/3)   Unpacking objects: 100% (3/3), done.
From https://github.com/skergoat/Dummy-Symfony-Tests-
 * branch            master     -> FETCH_HEAD
 * [new branch]      master     -> origin/master
fatal: refusing to merge unrelated histories
bash-3.2$ git push origin master
To https://github.com/skergoat/Dummy-Symfony-Tests-.git
 [31m! [rejected]       [m master -> master (non-fast-forward)
[31merror: failed to push some refs to 'https://github.com/skergoat/Dummy-Symfony-Tests-.git'
[m[33mhint: Updates were rejected because the tip of your current branch is behind[m
[33mhint: its remote counterpart. Integrate the remote changes (e.g.[m
[33mhint: 'git pull ...') before pushing again.[m
[33mhint: See the 'Note about fast-forwards' in 'git push --help' for details.[m
bash-3.2$ git pull
There is no tracking information for the current branch.
Please specify which branch you want to merge with.
See git-pull(1) for details.

    git pull <remote> <branch>

If you wish to set tracking information for this branch you can do so with:

    git branch --set-upstream-to=origin/<branch> master

bash-3.2$ git pull origin master  --allow-unrelated-histories
From https://github.com/skergoat/Dummy-Symfony-Tests-
 * branch            master     -> FETCH_HEAD
hint: Waiting for your editor to close the file... [?2004h[?1049h[?1h=[?2004h[1;15r[?12h[?12l[27m[29m[m[H[2J[?25l[15;1H"~/Desktop/tests/.git/MERGE_MSG" 7L, 301C[2;1H▽[6n[2;1H  [1;1H[>c]11;?[1;1HMerge branch 'master' of https://github.com/skergoat/Dummy-Symfony-Tests-

# Please enter a commit message to explain why this merge is necessary,
# especially if it merges an updated upstream into a topic branch.
#
# Lines starting with '#' will be ignored, and an empty message aborts
# the commit.
[94m~                                                                                                                                                      [9;1H~                                                                                                                                                      [10;1H~                                                                                                                                                      [11;1H~                                                                                                                                                      [12;1H~                                                                                                                                                      [13;1H~                                                                                                                                                      [14;1H~                                                                                                                                                      [1;1H[?25hP+q436f\P+q6b75\P+q6b64\P+q6b72\P+q6b6c\P+q2332\P+q2334\P+q2569\P+q2a37\P+q6b31\[?12$p





[?25l[m[15;1HType  :qa!  and press <Enter> to abandon all changes and exit Vim[7;1H[?25h[6;1H[5;1H[4;1H


[6;1H[5;1H[4;1H[3;1H[2;1H
# [?25l[15;1H[1m-- INSERT --[m[15;13H[K[4;14r[4;1H[L[1;15r[4;1H[?25h[?25l[3;14r[14;1H
[1;15r[3;1H# Please enter a commit message to explain why this merge is necessary,[14;1H[94m~                                                                                                                                                      [3;72H[?25h[2;1H[3;72H[4;67H
[m#[6;71H[7;14H[?25l[8;1H[K[8;1H[?25h[?25lh[?25h[?25le[?25h[?25ll[?25h[?25ll[?25h[?25lo[?25h[?25l[8;5H[K[8;5H[?25h[?25l[8;4H[K[8;4H[?25h[?25l[8;3H[K[8;3H[?25h[?25l[8;2H[K[8;2H[?25h[?25l[8;1H[K[8;1H[?25h[?25l[9;1H[K[9;1H[?25h[?25lf[?25h[?25li[?25h[?25lr[?25h[?25ls[?25h[?25lt[?25h[?25l [?25h[?25lc[?25h[?25lo[?25h[?25lm[?25h[?25lm[?25h[?25li[?25h[?25lt[?25h[?25l [?25h[?25l[10;1H[K[10;1H[?25h[?25l[11;1H[K[11;1H[?25h[?25l[12;1H[K[12;1H[?25h[?25l[13;1H[K[13;1H[?25h[?25l[14;1H[K[14;1H[?25h[?25l[1;14r[14;1H
[1;15r[14;1H[?25h[?25l[15;1H[K[14;1H[?25h[13;1H[12;1H[11;1H[10;1H[9;1H[8;1H[7;1H[6;1H[5;1H[4;1H[3;1H[2;1H[1;1H[?25l[1;14r[1;1H[L[1;15r[1;1HMerge branch 'master' of https://github.com/skergoat/Dummy-Symfony-Tests-[?25h












[?25l[1;14r[14;1H
[1;15r[14;1H[?25h

[?2004l[?1l>[?1049l[?2004l
[1]+  Stopped                 git pull origin master --allow-unrelated-histories
bash-3.2$ git push origin master
To https://github.com/skergoat/Dummy-Symfony-Tests-.git
 [31m! [rejected]       [m master -> master (non-fast-forward)
[31merror: failed to push some refs to 'https://github.com/skergoat/Dummy-Symfony-Tests-.git'
[m[33mhint: Updates were rejected because the tip of your current branch is behind[m
[33mhint: its remote counterpart. Integrate the remote changes (e.g.[m
[33mhint: 'git pull ...') before pushing again.[m
[33mhint: See the 'Note about fast-forwards' in 'git push --help' for details.[m
bash-3.2$ git add . 
bash-3.2$ git commit -am ''c'o'm'm'i't'
[master 5bd3394] commit
 Committer: Stephane <stephane@MacBook-Pro-de-Stephane.local>
Your name and email address were configured automatically based
on your username and hostname. Please check that they are accurate.
You can suppress this message by setting them explicitly. Run the
following command and follow the instructions in your editor to edit
your configuration file:

    git config --global --edit

After doing this, you may fix the identity used for this commit with:

    git commit --amend --reset-author

bash-3.2$ git push origin master
Enumerating objects: 167, done.
Counting objects:   0% (1/167)   Counting objects:   1% (2/167)   Counting objects:   2% (4/167)   Counting objects:   3% (6/167)   Counting objects:   4% (7/167)   Counting objects:   5% (9/167)   Counting objects:   6% (11/167)   Counting objects:   7% (12/167)   Counting objects:   8% (14/167)   Counting objects:   9% (16/167)   Counting objects:  10% (17/167)   Counting objects:  11% (19/167)   Counting objects:  12% (21/167)   Counting objects:  13% (22/167)   Counting objects:  14% (24/167)   Counting objects:  15% (26/167)   Counting objects:  16% (27/167)   Counting objects:  17% (29/167)   Counting objects:  18% (31/167)   Counting objects:  19% (32/167)   Counting objects:  20% (34/167)   Counting objects:  21% (36/167)   Counting objects:  22% (37/167)   Counting objects:  23% (39/167)   Counting objects:  24% (41/167)   Counting objects:  25% (42/167)   Counting objects:  26% (44/167)   Counting objects:  27% (46/167)   Counting objects:  28% (47/167)   Counting objects:  29% (49/167)   Counting objects:  30% (51/167)   Counting objects:  31% (52/167)   Counting objects:  32% (54/167)   Counting objects:  33% (56/167)   Counting objects:  34% (57/167)   Counting objects:  35% (59/167)   Counting objects:  36% (61/167)   Counting objects:  37% (62/167)   Counting objects:  38% (64/167)   Counting objects:  39% (66/167)   Counting objects:  40% (67/167)   Counting objects:  41% (69/167)   Counting objects:  42% (71/167)   Counting objects:  43% (72/167)   Counting objects:  44% (74/167)   Counting objects:  45% (76/167)   Counting objects:  46% (77/167)   Counting objects:  47% (79/167)   Counting objects:  48% (81/167)   Counting objects:  49% (82/167)   Counting objects:  50% (84/167)   Counting objects:  51% (86/167)   Counting objects:  52% (87/167)   Counting objects:  53% (89/167)   Counting objects:  54% (91/167)   Counting objects:  55% (92/167)   Counting objects:  56% (94/167)   Counting objects:  57% (96/167)   Counting objects:  58% (97/167)   Counting objects:  59% (99/167)   Counting objects:  60% (101/167)   Counting objects:  61% (102/167)   Counting objects:  62% (104/167)   Counting objects:  63% (106/167)   Counting objects:  64% (107/167)   Counting objects:  65% (109/167)   Counting objects:  66% (111/167)   Counting objects:  67% (112/167)   Counting objects:  68% (114/167)   Counting objects:  69% (116/167)   Counting objects:  70% (117/167)   Counting objects:  71% (119/167)   Counting objects:  72% (121/167)   Counting objects:  73% (122/167)   Counting objects:  74% (124/167)   Counting objects:  75% (126/167)   Counting objects:  76% (127/167)   Counting objects:  77% (129/167)   Counting objects:  78% (131/167)   Counting objects:  79% (132/167)   Counting objects:  80% (134/167)   Counting objects:  81% (136/167)   Counting objects:  82% (137/167)   Counting objects:  83% (139/167)   Counting objects:  84% (141/167)   Counting objects:  85% (142/167)   Counting objects:  86% (144/167)   Counting objects:  87% (146/167)   Counting objects:  88% (147/167)   Counting objects:  89% (149/167)   Counting objects:  90% (151/167)   Counting objects:  91% (152/167)   Counting objects:  92% (154/167)   Counting objects:  93% (156/167)   Counting objects:  94% (157/167)   Counting objects:  95% (159/167)   Counting objects:  96% (161/167)   Counting objects:  97% (162/167)   Counting objects:  98% (164/167)   Counting objects:  99% (166/167)   Counting objects: 100% (167/167)   Counting objects: 100% (167/167), done.
Delta compression using up to 8 threads
Compressing objects:   0% (1/158)   Compressing objects:   1% (2/158)   Compressing objects:   2% (4/158)   Compressing objects:   3% (5/158)   Compressing objects:   4% (7/158)   Compressing objects:   5% (8/158)   Compressing objects:   6% (10/158)   Compressing objects:   7% (12/158)   Compressing objects:   8% (13/158)   Compressing objects:   9% (15/158)   Compressing objects:  10% (16/158)   Compressing objects:  11% (18/158)   Compressing objects:  12% (19/158)   Compressing objects:  13% (21/158)   Compressing objects:  14% (23/158)   Compressing objects:  15% (24/158)   Compressing objects:  16% (26/158)   Compressing objects:  17% (27/158)   Compressing objects:  18% (29/158)   Compressing objects:  19% (31/158)   Compressing objects:  20% (32/158)   Compressing objects:  21% (34/158)   Compressing objects:  22% (35/158)   Compressing objects:  23% (37/158)   Compressing objects:  24% (38/158)   Compressing objects:  25% (40/158)   Compressing objects:  26% (42/158)   Compressing objects:  27% (43/158)   Compressing objects:  28% (45/158)   Compressing objects:  29% (46/158)   Compressing objects:  30% (48/158)   Compressing objects:  31% (49/158)   Compressing objects:  32% (51/158)   Compressing objects:  33% (53/158)   Compressing objects:  34% (54/158)   Compressing objects:  35% (56/158)   Compressing objects:  36% (57/158)   Compressing objects:  37% (59/158)   Compressing objects:  38% (61/158)   Compressing objects:  39% (62/158)   Compressing objects:  40% (64/158)   Compressing objects:  41% (65/158)   Compressing objects:  42% (67/158)   Compressing objects:  43% (68/158)   Compressing objects:  44% (70/158)   Compressing objects:  45% (72/158)   Compressing objects:  46% (73/158)   Compressing objects:  47% (75/158)   Compressing objects:  48% (76/158)   Compressing objects:  49% (78/158)   Compressing objects:  50% (79/158)   Compressing objects:  51% (81/158)   Compressing objects:  52% (83/158)   Compressing objects:  53% (84/158)   Compressing objects:  54% (86/158)   Compressing objects:  55% (87/158)   Compressing objects:  56% (89/158)   Compressing objects:  57% (91/158)   Compressing objects:  58% (92/158)   Compressing objects:  59% (94/158)   Compressing objects:  60% (95/158)   Compressing objects:  61% (97/158)   Compressing objects:  62% (98/158)   Compressing objects:  63% (100/158)   Compressing objects:  64% (102/158)   Compressing objects:  65% (103/158)   Compressing objects:  66% (105/158)   Compressing objects:  67% (106/158)   Compressing objects:  68% (108/158)   Compressing objects:  69% (110/158)   Compressing objects:  70% (111/158)   Compressing objects:  71% (113/158)   Compressing objects:  72% (114/158)   Compressing objects:  73% (116/158)   Compressing objects:  74% (117/158)   Compressing objects:  75% (119/158)   Compressing objects:  76% (121/158)   Compressing objects:  77% (122/158)   Compressing objects:  78% (124/158)   Compressing objects:  79% (125/158)   Compressing objects:  80% (127/158)   Compressing objects:  81% (128/158)   Compressing objects:  82% (130/158)   Compressing objects:  83% (132/158)   Compressing objects:  84% (133/158)   Compressing objects:  85% (135/158)   Compressing objects:  86% (136/158)   Compressing objects:  87% (138/158)   Compressing objects:  88% (140/158)   Compressing objects:  89% (141/158)   Compressing objects:  90% (143/158)   Compressing objects:  91% (144/158)   Compressing objects:  92% (146/158)   Compressing objects:  93% (147/158)   Compressing objects:  94% (149/158)   Compressing objects:  95% (151/158)   Compressing objects:  96% (152/158)   Compressing objects:  97% (154/158)   Compressing objects:  98% (155/158)   Compressing objects:  99% (157/158)   Compressing objects: 100% (158/158)   Compressing objects: 100% (158/158), done.
Writing objects:   0% (1/166)   Writing objects:   1% (2/166)   Writing objects:   2% (4/166)   Writing objects:   3% (5/166)   Writing objects:   4% (7/166)   Writing objects:   5% (9/166)   Writing objects:   6% (10/166)   Writing objects:   7% (12/166)   Writing objects:   8% (14/166)   Writing objects:   9% (15/166)   Writing objects:  10% (17/166)   Writing objects:  11% (19/166)   Writing objects:  12% (20/166)   Writing objects:  13% (22/166)   Writing objects:  14% (24/166)   Writing objects:  15% (25/166)   Writing objects:  16% (27/166)   Writing objects:  17% (29/166)   Writing objects:  18% (30/166)   Writing objects:  19% (32/166)   Writing objects:  20% (34/166)   Writing objects:  21% (35/166)   Writing objects:  22% (37/166)   Writing objects:  23% (39/166)   Writing objects:  24% (40/166)   Writing objects:  25% (42/166)   Writing objects:  26% (44/166)   Writing objects:  27% (45/166)   Writing objects:  28% (47/166)   Writing objects:  29% (49/166)   Writing objects:  30% (50/166)   Writing objects:  31% (52/166)   Writing objects:  32% (54/166)   Writing objects:  33% (55/166)   Writing objects:  34% (57/166)   Writing objects:  35% (59/166)   Writing objects:  36% (60/166)   Writing objects:  37% (62/166)   Writing objects:  38% (64/166)   Writing objects:  39% (65/166)   Writing objects:  40% (67/166)   Writing objects:  41% (69/166)   Writing objects:  42% (70/166)   Writing objects:  43% (72/166)   Writing objects:  45% (75/166)   Writing objects:  46% (77/166)   Writing objects:  47% (79/166)   Writing objects:  48% (80/166)   Writing objects:  49% (82/166)   Writing objects:  50% (83/166)   Writing objects:  51% (85/166)   Writing objects:  52% (87/166)   Writing objects:  53% (89/166)   Writing objects:  54% (90/166)   Writing objects:  55% (92/166)   Writing objects:  56% (93/166)   Writing objects:  57% (95/166)   Writing objects:  58% (97/166)   Writing objects:  59% (98/166)   Writing objects:  60% (100/166)   Writing objects:  61% (102/166)   Writing objects:  62% (103/166)   Writing objects:  63% (105/166)   Writing objects:  64% (107/166)   Writing objects:  65% (108/166)   Writing objects:  66% (110/166)   Writing objects:  67% (112/166)   Writing objects:  68% (113/166)   Writing objects:  69% (115/166)   Writing objects:  70% (117/166)   Writing objects:  71% (118/166)   Writing objects:  72% (120/166)   Writing objects:  73% (122/166)   Writing objects:  74% (123/166)   Writing objects:  75% (125/166)   Writing objects:  76% (127/166)   Writing objects:  77% (128/166)   Writing objects:  78% (131/166)   Writing objects:  80% (133/166)   Writing objects:  81% (135/166)   Writing objects:  82% (137/166)   Writing objects:  83% (138/166)   Writing objects:  84% (140/166)   Writing objects:  85% (142/166)   Writing objects:  86% (143/166)   Writing objects:  87% (145/166)   Writing objects:  88% (147/166)   Writing objects:  89% (148/166)   Writing objects:  90% (150/166)   Writing objects:  92% (153/166)   Writing objects:  93% (155/166)   Writing objects:  94% (157/166)   Writing objects:  95% (158/166)   Writing objects:  96% (160/166)   Writing objects:  97% (162/166)   Writing objects:  98% (163/166)   Writing objects:  99% (165/166)   Writing objects: 100% (166/166)   Writing objects: 100% (166/166), 262.29 KiB | 5.96 MiB/s, done.
Total 166 (delta 37), reused 0 (delta 0)
remote: Resolving deltas:   0% (0/37)[Kremote: Resolving deltas:   2% (1/37)[Kremote: Resolving deltas:   5% (2/37)[Kremote: Resolving deltas:   8% (3/37)[Kremote: Resolving deltas:  29% (11/37)[Kremote: Resolving deltas:  48% (18/37)[Kremote: Resolving deltas:  56% (21/37)[Kremote: Resolving deltas:  59% (22/37)[Kremote: Resolving deltas:  67% (25/37)[Kremote: Resolving deltas:  75% (28/37)[Kremote: Resolving deltas:  89% (33/37)[Kremote: Resolving deltas:  91% (34/37)[Kremote: Resolving deltas:  94% (35/37)[Kremote: Resolving deltas: 100% (37/37)[Kremote: Resolving deltas: 100% (37/37), done.[K
To https://github.com/skergoat/Dummy-Symfony-Tests-.git
   4e3a190..5bd3394  master -> master
bash-3.2$ git push origin master
Everything up-to-date
bash-3.2$ Tests-

# Please enter a commit message to explain why this merge is necessary,
# especially if it merges an updated upstream into a topic branch.
#
# Lines starting with '#' will be ignored, and an empty message aborts
# the commit.
[94m~                                                                                                                                                      [9;1H~                                                                                                                                                      [10;1H~                                                                                                                                                      [11;1H~                                                                                                                                                      [12;1H~                                                                                                                                                      [13;1H~                                                                                                                                                      [14;1H~                                                                                                                                                      [1;1H[?25hP+q436f\P+q6b75\P+q6b64\P+q6b72\P+q6b6c\P+q2332\P+q2334\P+q2569\P+q2a37\P+q6b31\[?12$p





[?25l[m[15;1HType  :qa!  and press <Enter> to abandon all changes and exit Vim[7;1H[?25h[6;1H[5;1H[4;1H


[6;1H[5;1H[4;1H[3;1H[2;1H
# [?25l[15;1H[1m-- INSERT --[m[15;13H[K[4;14r[4;1H[L[1;15r[4;1H[?25h[?25l[3;14r[14;1H
[1;15r[3;1H# Please enter a commit message to explain why this merge is necessary,[14;1H[94m~                                                                                                                                                      [3;72H[?25h[2;1H[3;72H[4;67H
[m#[6;71H[7;14H[?25l[8;1H[K[8;1H[?25h[?25lh[?25h[?25le[?25h[?25ll[?25h[?25ll[?25h[?25lo[?25h[?25l[8;5H[K[8;5H[?25h[?25l[8;4H[K[8;4H[?25h[?25l[8;3H[K[8;3H[?25h[?25l[8;2H[K[8;2H[?25h[?25l[8;1H[K[8;1H[?25h[?25l[9;1H[K[9;1H[?25h[?25lf[?25h[?25li[?25h[?25lr[?25h[?25ls[?25h[?25lt[?25h[?25l [?25h[?25lc[?25h[?25lo[?25h[?25lm[?25h[?25lm[?25h[?25li[?25h[?25lt[?25h[?25l [?25h[?25l[10;1H[K[10;1H[?25h[?25l[11;1H[K[11;1H[?25h[?25l[12;1H[K[12;1H[?25h[?25l[13;1H[K[13;1H[?25h[?25l[14;1H[K[14;1H[?25h[?25l[1;14r[14;1H
[1;15r[14;1H[?25h[?25l[15;1H[K[14;1H[?25h[13;1H[12;1H[11;1H[10;1H[9;1H[8;1H[7;1H[6;1H[5;1H[4;1H[3;1H[2;1H[1;1H[?25l[1;14r[1;1H[L[1;15r[1;1HMerge branch 'master' of https://github.com/skergoat/Dummy-Symfony-Tests-[?25h












[?25l[1;14r[14;1H
[1;15r[14;1H[?25h

[?2004l[?1l>[?1049l[?2004l
[1]+  Stopped                 git pull origin master --allow-unrelated-histories
bash-3.2$ git push origin master
To https://github.com/skergoat/Dummy-Symfony-Tests-.git
 [31m! [rejected]       [m master -> master (non-fast-forward)
[31merror: failed to push some refs to 'https://github.com/skergoat/Dummy-Symfony-Tests-.git'
[m[33mhint: Updates were rejected because the tip of your current branch is behind[m
[33mhint: its remote counterpart. Integrate the remote changes (e.g.[m
[33mhint: 'git pull ...') before pushing again.[m
[33mhint: See the 'Note about fast-forwards' in 'git push --help' for details.[m
bash-3.2$ git add . 
bash-3.2$ git commit -am ''c'o'm'm'i't'
[master 5bd3394] commit
 Committer: Stephane <stephane@MacBook-Pro-de-Stephane.local>
Your name and email address were configured automatically based
on your username and hostname. Please check that they are accurate.
You can suppress this message by setting them explicitly. Run the
following command and follow the instructions in your editor to edit
your configuration file:

    git config --global --edit

After doing this, you may fix the identity used for this commit with:

    git commit --amend --reset-author

bash-3.2$ git push origin master
Enumerating objects: 167, done.
Counting objects:   0% (1/167)   Counting objects:   1% (2/167)   Counting objects:   2% (4/167)   Counting objects:   3% (6/167)   Counting objects:   4% (7/167)   Counting objects:   5% (9/167)   Counting objects:   6% (11/167)   Counting objects:   7% (12/167)   Counting objects:   8% (14/167)   Counting objects:   9% (16/167)   Counting objects:  10% (17/167)   Counting objects:  11% (19/167)   Counting objects:  12% (21/167)   Counting objects:  13% (22/167)   Counting objects:  14% (24/167)   Counting objects:  15% (26/167)   Counting objects:  16% (27/167)   Counting objects:  17% (29/167)   Counting objects:  18% (31/167)   Counting objects:  19% (32/167)   Counting objects:  20% (34/167)   Counting objects:  21% (36/167)   Counting objects:  22% (37/167)   Counting objects:  23% (39/167)   Counting objects:  24% (41/167)   Counting objects:  25% (42/167)   Counting objects:  26% (44/167)   Counting objects:  27% (46/167)   Counting objects:  28% (47/167)   Counting objects:  29% (49/167)   Counting objects:  30% (51/167)   Counting objects:  31% (52/167)   Counting objects:  32% (54/167)   Counting objects:  33% (56/167)   Counting objects:  34% (57/167)   Counting objects:  35% (59/167)   Counting objects:  36% (61/167)   Counting objects:  37% (62/167)   Counting objects:  38% (64/167)   Counting objects:  39% (66/167)   Counting objects:  40% (67/167)   Counting objects:  41% (69/167)   Counting objects:  42% (71/167)   Counting objects:  43% (72/167)   Counting objects:  44% (74/167)   Counting objects:  45% (76/167)   Counting objects:  46% (77/167)   Counting objects:  47% (79/167)   Counting objects:  48% (81/167)   Counting objects:  49% (82/167)   Counting objects:  50% (84/167)   Counting objects:  51% (86/167)   Counting objects:  52% (87/167)   Counting objects:  53% (89/167)   Counting objects:  54% (91/167)   Counting objects:  55% (92/167)   Counting objects:  56% (94/167)   Counting objects:  57% (96/167)   Counting objects:  58% (97/167)   Counting objects:  59% (99/167)   Counting objects:  60% (101/167)   Counting objects:  61% (102/167)   Counting objects:  62% (104/167)   Counting objects:  63% (106/167)   Counting objects:  64% (107/167)   Counting objects:  65% (109/167)   Counting objects:  66% (111/167)   Counting objects:  67% (112/167)   Counting objects:  68% (114/167)   Counting objects:  69% (116/167)   Counting objects:  70% (117/167)   Counting objects:  71% (119/167)   Counting objects:  72% (121/167)   Counting objects:  73% (122/167)   Counting objects:  74% (124/167)   Counting objects:  75% (126/167)   Counting objects:  76% (127/167)   Counting objects:  77% (129/167)   Counting objects:  78% (131/167)   Counting objects:  79% (132/167)   Counting objects:  80% (134/167)   Counting objects:  81% (136/167)   Counting objects:  82% (137/167)   Counting objects:  83% (139/167)   Counting objects:  84% (141/167)   Counting objects:  85% (142/167)   Counting objects:  86% (144/167)   Counting objects:  87% (146/167)   Counting objects:  88% (147/167)   Counting objects:  89% (149/167)   Counting objects:  90% (151/167)   Counting objects:  91% (152/167)   Counting objects:  92% (154/167)   Counting objects:  93% (156/167)   Counting objects:  94% (157/167)   Counting objects:  95% (159/167)   Counting objects:  96% (161/167)   Counting objects:  97% (162/167)   Counting objects:  98% (164/167)   Counting objects:  99% (166/167)   Counting objects: 100% (167/167)   Counting objects: 100% (167/167), done.
Delta compression using up to 8 threads
Compressing objects:   0% (1/158)   Compressing objects:   1% (2/158)   Compressing objects:   2% (4/158)   Compressing objects:   3% (5/158)   Compressing objects:   4% (7/158)   Compressing objects:   5% (8/158)   Compressing objects:   6% (10/158)   Compressing objects:   7% (12/158)   Compressing objects:   8% (13/158)   Compressing objects:   9% (15/158)   Compressing objects:  10% (16/158)   Compressing objects:  11% (18/158)   Compressing objects:  12% (19/158)   Compressing objects:  13% (21/158)   Compressing objects:  14% (23/158)   Compressing objects:  15% (24/158)   Compressing objects:  16% (26/158)   Compressing objects:  17% (27/158)   Compressing objects:  18% (29/158)   Compressing objects:  19% (31/158)   Compressing objects:  20% (32/158)   Compressing objects:  21% (34/158)   Compressing objects:  22% (35/158)   Compressing objects:  23% (37/158)   Compressing objects:  24% (38/158)   Compressing objects:  25% (40/158)   Compressing objects:  26% (42/158)   Compressing objects:  27% (43/158)   Compressing objects:  28% (45/158)   Compressing objects:  29% (46/158)   Compressing objects:  30% (48/158)   Compressing objects:  31% (49/158)   Compressing objects:  32% (51/158)   Compressing objects:  33% (53/158)   Compressing objects:  34% (54/158)   Compressing objects:  35% (56/158)   Compressing objects:  36% (57/158)   Compressing objects:  37% (59/158)   Compressing objects:  38% (61/158)   Compressing objects:  39% (62/158)   Compressing objects:  40% (64/158)   Compressing objects:  41% (65/158)   Compressing objects:  42% (67/158)   Compressing objects:  43% (68/158)   Compressing objects:  44% (70/158)   Compressing objects:  45% (72/158)   Compressing objects:  46% (73/158)   Compressing objects:  47% (75/158)   Compressing objects:  48% (76/158)   Compressing objects:  49% (78/158)   Compressing objects:  50% (79/158)   Compressing objects:  51% (81/158)   Compressing objects:  52% (83/158)   Compressing objects:  53% (84/158)   Compressing objects:  54% (86/158)   Compressing objects:  55% (87/158)   Compressing objects:  56% (89/158)   Compressing objects:  57% (91/158)   Compressing objects:  58% (92/158)   Compressing objects:  59% (94/158)   Compressing objects:  60% (95/158)   Compressing objects:  61% (97/158)   Compressing objects:  62% (98/158)   Compressing objects:  63% (100/158)   Compressing objects:  64% (102/158)   Compressing objects:  65% (103/158)   Compressing objects:  66% (105/158)   Compressing objects:  67% (106/158)   Compressing objects:  68% (108/158)   Compressing objects:  69% (110/158)   Compressing objects:  70% (111/158)   Compressing objects:  71% (113/158)   Compressing objects:  72% (114/158)   Compressing objects:  73% (116/158)   Compressing objects:  74% (117/158)   Compressing objects:  75% (119/158)   Compressing objects:  76% (121/158)   Compressing objects:  77% (122/158)   Compressing objects:  78% (124/158)   Compressing objects:  79% (125/158)   Compressing objects:  80% (127/158)   Compressing objects:  81% (128/158)   Compressing objects:  82% (130/158)   Compressing objects:  83% (132/158)   Compressing objects:  84% (133/158)   Compressing objects:  85% (135/158)   Compressing objects:  86% (136/158)   Compressing objects:  87% (138/158)   Compressing objects:  88% (140/158)   Compressing objects:  89% (141/158)   Compressing objects:  90% (143/158)   Compressing objects:  91% (144/158)   Compressing objects:  92% (146/158)   Compressing objects:  93% (147/158)   Compressing objects:  94% (149/158)   Compressing objects:  95% (151/158)   Compressing objects:  96% (152/158)   Compressing objects:  97% (154/158)   Compressing objects:  98% (155/158)   Compressing objects:  99% (157/158)   Compressing objects: 100% (158/158)   Compressing objects: 100% (158/158), done.
Writing objects:   0% (1/166)   Writing objects:   1% (2/166)   Writing objects:   2% (4/166)   Writing objects:   3% (5/166)   Writing objects:   4% (7/166)   Writing objects:   5% (9/166)   Writing objects:   6% (10/166)   Writing objects:   7% (12/166)   Writing objects:   8% (14/166)   Writing objects:   9% (15/166)   Writing objects:  10% (17/166)   Writing objects:  11% (19/166)   Writing objects:  12% (20/166)   Writing objects:  13% (22/166)   Writing objects:  14% (24/166)   Writing objects:  15% (25/166)   Writing objects:  16% (27/166)   Writing objects:  17% (29/166)   Writing objects:  18% (30/166)   Writing objects:  19% (32/166)   Writing objects:  20% (34/166)   Writing objects:  21% (35/166)   Writing objects:  22% (37/166)   Writing objects:  23% (39/166)   Writing objects:  24% (40/166)   Writing objects:  25% (42/166)   Writing objects:  26% (44/166)   Writing objects:  27% (45/166)   Writing objects:  28% (47/166)   Writing objects:  29% (49/166)   Writing objects:  30% (50/166)   Writing objects:  31% (52/166)   Writing objects:  32% (54/166)   Writing objects:  33% (55/166)   Writing objects:  34% (57/166)   Writing objects:  35% (59/166)   Writing objects:  36% (60/166)   Writing objects:  37% (62/166)   Writing objects:  38% (64/166)   Writing objects:  39% (65/166)   Writing objects:  40% (67/166)   Writing objects:  41% (69/166)   Writing objects:  42% (70/166)   Writing objects:  43% (72/166)   Writing objects:  45% (75/166)   Writing objects:  46% (77/166)   Writing objects:  47% (79/166)   Writing objects:  48% (80/166)   Writing objects:  49% (82/166)   Writing objects:  50% (83/166)   Writing objects:  51% (85/166)   Writing objects:  52% (87/166)   Writing objects:  53% (89/166)   Writing objects:  54% (90/166)   Writing objects:  55% (92/166)   Writing objects:  56% (93/166)   Writing objects:  57% (95/166)   Writing objects:  58% (97/166)   Writing objects:  59% (98/166)   Writing objects:  60% (100/166)   Writing objects:  61% (102/166)   Writing objects:  62% (103/166)   Writing objects:  63% (105/166)   Writing objects:  64% (107/166)   Writing objects:  65% (108/166)   Writing objects:  66% (110/166)   Writing objects:  67% (112/166)   Writing objects:  68% (113/166)   Writing objects:  69% (115/166)   Writing objects:  70% (117/166)   Writing objects:  71% (118/166)   Writing objects:  72% (120/166)   Writing objects:  73% (122/166)   Writing objects:  74% (123/166)   Writing objects:  75% (125/166)   Writing objects:  76% (127/166)   Writing objects:  77% (128/166)   Writing objects:  78% (131/166)   Writing objects:  80% (133/166)   Writing objects:  81% (135/166)   Writing objects:  82% (137/166)   Writing objects:  83% (138/166)   Writing objects:  84% (140/166)   Writing objects:  85% (142/166)   Writing objects:  86% (143/166)   Writing objects:  87% (145/166)   Writing objects:  88% (147/166)   Writing objects:  89% (148/166)   Writing objects:  90% (150/166)   Writing objects:  92% (153/166)   Writing objects:  93% (155/166)   Writing objects:  94% (157/166)   Writing objects:  95% (158/166)   Writing objects:  96% (160/166)   Writing objects:  97% (162/166)   Writing objects:  98% (163/166)   Writing objects:  99% (165/166)   Writing objects: 100% (166/166)   Writing objects: 100% (166/166), 262.29 KiB | 5.96 MiB/s, done.
Total 166 (delta 37), reused 0 (delta 0)
remote: Resolving deltas:   0% (0/37)[Kremote: Resolving deltas:   2% (1/37)[Kremote: Resolving deltas:   5% (2/37)[Kremote: Resolving deltas:   8% (3/37)[Kremote: Resolving deltas:  29% (11/37)[Kremote: Resolving deltas:  48% (18/37)[Kremote: Resolving deltas:  56% (21/37)[Kremote: Resolving deltas:  59% (22/37)[Kremote: Resolving deltas:  67% (25/37)[Kremote: Resolving deltas:  75% (28/37)[Kremote: Resolving deltas:  89% (33/37)[Kremote: Resolving deltas:  91% (34/37)[Kremote: Resolving deltas:  94% (35/37)[Kremote: Resolving deltas: 100% (37/37)[Kremote: Resolving deltas: 100% (37/37), done.[K
To https://github.com/skergoat/Dummy-Symfony-Tests-.git
   4e3a190..5bd3394  master -> master
bash-3.2$ git push origin master
Everything up-to-date
bash-3.2$ 